1111111111
10000000X1
10000000C1
1C10000101
1P000000E1
1111111111