11111111111111111111111
1P000010C000000010X0001
11000000000C00000000001
1000C000000000000000001
1000C000000000000000001
10000000000000000000001
1O1000000000000000000E1
11111111111111111111111