1111111111
1000000001
10000000C1
1C10000101
1P000000E1
1111111111